111111111116111
120000000000006
101010101010101
100000000000001
101010101010101
100000000000001
101013101010101
100000000000005
101010101010101
100000000000001
101010101010101
100000000000001
101010101010104
600000000000001
101010101010101
100000000000001
101010101010101
100000000000006
111161111611111