11111111111111
10000000000001
10111101111101
10111101111101
10111101111101
10000000000000
10111101101111
10111101101111
10000001100001
11111101111101
11111101111101
11111101100000
11111101101112
11111101101333
00000000001333
11111101101111
11111101100000
11111101101111