1111111111161111
1000000000000006
1000000000000001
1000000000000004
6000000000000001
1000000000000001
1000000000000005
1111161111611111
