11116111161111
12000000000006
10000000000001
10000000000001
60000000000001
10000030000001
10000000000005
10000000000001
60000000000001
10000000000001
10000000000001
10000000000004
10000000000001
60000000000001
10000000000001
10000000000001
10000000000006
11116111161111