1111111111161111
1200000000000006
1010101010101001
1000030000000004
6010101010101001
1000000000000005
1111116111161111
