11111111111111
12000000000001
10111101111101
10111101111101
10111101111101
10000030000005
10111101101111
10111101101111
10000001100001
11111101111101
11111101111101
11111101100004
11111101101111
11111101101111
00000000001111
11111101101111
11111101100000
11111101101111