111111111116111
120000000000006
101010101010101
100003000000004
601010101010101
100000000000005
111111611116111